NO ./textures/512x512/test2.xpm
SO ./textures/512x512/test2.xpm
WE ./textures/512x512/test6.xpm
EA ./textures/512x512/test8.xpm
F 158,104,105
C 117,197,179

1           111     11
11111111111111111
100000000000001
100000000000011 1 1
1000S0001110001111
100000001 10000001
100000001110001111
100000000000001
111000111110111
11100000001111111
1111111011011
111111111111