NO ./textures/Nature/Rocks.xpm
SO ./textures/Nature/Wood.xpm
WE ./textures/Nature/Tree.xpm
EA ./textures/Nature/Hedge2.xpm
C 153,153,255
F 155,209,74

11111111111111111111111111000000001111111
10000000000000000000000000000000010000001
11111000000000000000000000000111110000001
11100000000000000000000000000000000000001
100000000000000000000011111111111100000N1
10000000000000000000001000000000010000001
11111100000000000000001000000000010000001
10000100000000000000001000000000010000001
10000100000000000000001000000000010000001
10000011100000000000001000000000010000001
11000000000000000000001000000000010000001
11111100000000000000000000000000010000001
10000000000000000000000000000000010000001
10011111111111111111111111111111111111111
1111