NO ./textures/Nature/Rocks.xpm
SO ./textures/Nature/Wood.xpm
WE ./textures/Nature/Tree.xpm
EA ./textures/Nature/Hedge.xpm

C 153,153,255
F 155,209,74

1111111111111111111111111111111
1100000000011000000000000000011
1101110000011100000000000010001
1100110000000000000000000010001
1101110000011100000000000010001
1100000000011000000010111100011
1111101111111110111000000100011
1111101111111110111010100100011
1110000001101010111000000100011
1100000000000000011000000100011
1100000000000000011010100100011
1110000001101010000000000000011
1111101111101010000001010000011
1100000000011000000000000100011
1100000000000000000001000010011
1100000000010000100000000010011
1100000000011010000N00000000011
1100000000001000000010100000011
1111111111111111111111111111111